NO ./textures/color_stone.xpm
WE ./textures/blue_stone.xpm
EA ./textures/grey_stone.xpm
   C     49, 49, 49

   F     118, 118, 118

  SO ./textures/purple_stone.xpm
       
11111111111111111
10100001000000001
11100001001000101
10100001000001001
10000001100000001
1000010000000100111111111111111111111111111111111111111111111111111111111111111111111
1000000100000000000000000000000000000000000000000000000000000000000000000000000000E01
11111111111111111111111111111111111111111111111111111111111111111111111111111111111111