NO ./textures/color_stone.xpm
WE ./textures/blue_stone.xpm
EA     ./textures/grey_stone.xpm
 SO ./textures/purple_stone.xpm

F 220,100, 0
C 225,30,0 
1111111111111111111111111
1000000000110000000000001
1011000001110000000000001
10010000000000000000000011111111
1111111110110000011100000000N0001
10000000001100000111011111111111
11110111111111011100000010001
111101111111110111010100100011
11000000110101011100000010001
10000000000000001100000010001
10000000000000001101010010001
1100000111010101111101111000111
11110111 1110101 101111010001
11111111 1111111 111111111111