NO ./path1
WE ./path4
EA ./path3
   C     173,  216, 230

  F   0, 100, 0

  SO ./pathX
       
11111111
10100001
10100001
10100001
1000S001
10000101
10000001
11111111