NO ./textures/color_stone.xpm
WE ./textures/blue_stone.xpm
EA ./textures/grey_stone.xpm
   C     49, 49, 49

   F     118, 118, 118

  SO ./textures/purple_stone.xpm
       
11111111111111111
10100001000000001
10100001001000101
10100001000001001
1000S001100000001
10000100000001001
10000001000000001
11111111111111111