NO ./textures/blue_stone.xpm
WE ./textures/color_stone.xpm
EA ./textures/grey_stone.xpm
   C     173,  216, 230

  F   0, 100, 0

  SO ./textures/purple_stone.xpm
       
11111111111111111
10100001000000001
10100001001000101
10100001000001001
1000S001100000001
10000100000001001
10000001000000001
11111111111111111