NO ./path1
SO ./path2
EA ./path3
WE ./path4

F 220,100,0
C 225,30,0

111111
  1001
1110N1
  1111
