NO ./path1
WE ./path4
EA ./path3
   C     225 , 30, 1 

  F   20,  158, 10

  SO ./pathX

111111111111111111111111
10011        101
10N1111111111111111111111111
11111              1
11111              1
11111111111111111111